################x###############
#..........#.....#.............#
#..........#.#...#.............#
#..........#.#...#.............#
#..........#.#...#.............#
#..........#.# ..#.............#
#..........#.#...#.............#
#..........#.#....######.......#
#..........#.#........##.......#
#..........#.########G##.......#
#..........#.....#....##.......#
#..........#....G#.#####.......#
#..........#.....#.....#.......#
#..........###.#######.#.......#
#..........###.#.......#.......#
#..........###.#.#######.......#
#..........###.#...G...#.......#
#..........###.#######.#.......#
#..........#...........#.......#
#..........#...G.......#.......#
#..........#############.......#
#..............................#
#..............................#
#..............................#
#..............................#
#..............................#
#..............................#
#..............................#
#..............................#
#..............................#
#..............................#
################################
